###################
#........#........#
#P##.###.#.###.##P#
#.................#
#.##.#.#####.#.##.#
#....#...#...#....#
####.###.#.###.####
####.#.......#.####
####.#.FF1FF.#.####
L......F234F......R
####.#.FFFFF.#.####
####.#...I...#.####
####.#.#####.#.####
#........#........#
#.##.###.#.###.##.#
#P.#.....S.....#.P#
##.#.#.#####.#.#.##
#....#...#...#....#
#.######.#.######.#
#.................#
###################